%%%%%%
%%   %
% % P%
% %  %
% .  %
%%%%%%