%%%%%%
% P  %
% %  %
%%%% %
%.   %
%%%%%%